20 20
4 4
2 2 2 2 2 2 2 2 2 2 2 2 2 2 2 2 2 2 2 2
2 0 0 0 0 0 0 0 0 0 0 0 0 0 0 0 0 0 1 2
2 0 0 0 0 1 1 1 1 0 0 0 0 0 0 0 0 0 0 2
2 0 0 0 0 1 1 1 1 1 1 1 1 1 1 1 1 0 0 2
2 0 0 0 0 0 0 0 0 0 0 0 0 0 0 0 0 0 0 2
2 0 0 0 1 0 0 0 0 0 0 0 0 0 0 0 0 0 0 2
2 0 0 0 1 0 0 0 0 0 0 0 0 0 0 0 0 0 0 2
2 0 0 0 1 0 0 0 0 0 0 0 0 0 0 0 0 0 0 2
2 0 0 0 1 0 0 0 0 0 0 0 0 0 0 0 0 0 0 2
2 0 0 0 1 0 0 0 0 0 0 0 0 0 0 0 0 0 0 2
2 0 0 0 1 0 0 0 0 0 2 2 2 2 0 2 0 2 0 2
2 0 0 0 1 0 0 0 0 0 2 0 0 2 0 2 0 2 0 2
2 0 0 0 0 3 4 4 4 4 4 5 0 2 0 2 0 2 0 2
2 0 0 0 0 3 4 4 4 4 4 5 0 2 0 2 0 2 0 2
2 0 2 2 2 3 4 4 4 4 4 5 0 2 2 2 0 2 0 2
2 0 2 0 0 3 4 4 4 4 4 5 0 0 0 0 0 2 0 2
2 0 2 0 0 3 4 4 4 4 4 5 0 0 0 0 0 2 0 2
2 0 2 2 2 3 4 4 4 4 4 5 2 2 2 2 2 2 0 2
2 1 0 0 0 3 4 4 4 4 4 5 0 0 0 0 0 0 1 2
2 2 2 2 2 2 2 2 2 2 2 2 2 2 2 2 2 2 2 2
